111111111111111111111111111111111111111111111111111111111111111
1000000C0000000000C0000000000000001111100000N000000001000000001
11111111111110000000000N000000000000110000000C00000000000000001
10000P000000000000000000000000000000000000000000000000000000001
100000000000000N00000000000000000C00000000000000000000000000001
100000000000000000000000000000000000000000000000000000000000001
100000000000000000000000000000000000000000000000000000000000001
100000000000000000000000000C00000000C11111111111111111100000001
10000N000000000000000000000001111111111111111111111111111111111
111111111111111110000000000000000000000000000000000001111111111
1111E1111111111111111111111000000000011111111111111111111111111
111101111111111111110000000000001111111111111111111111111111111
1111011111100000000000000N0000001111111111111111111111111111111
111101111111111100000000000000000000000000000000000000000000001
1000000000000000000000000000C0000000000000000000000000000000001
1000000000C0000000000000000000000000000N00000000000000000000001
1000000000000000000000000000000000000000000000000000000000000C1
1000000000N00000000000000000000000000000000000000000000000000N1
1000000000000000000000C0000000000000000000000000000000000000001
111111111111111111111111111111111111111111111111111111111111111