111111111111111111111111111
1110000000000011111C1111111
111P111111111111111C1111111
1100000000E0000000111111111
1C0000000011111111111111111
111111111111111111111111111