111111111
1000C0001
1P00000E1
100C01111
1N0000C11
111111111