111111111111111
100000000000001
1000P0000000001
100000000000001
100000000111111
100000000000001
10000000C000001
111111111111111