111111111111111111111111111111
1P0000000C00000000000000000001
100000000000000C0000C000000001
10000000C00000000000000C000001
1E000C00011111C00C001011111101
100000000000001011111111111111
10000000C00000C000000000110001
10000000000C0000C0000000001101
1C000000000000000000C000011101
1000000000C000000CCC00000110C1
1000000000CC000001111000001001
100000000000011110000011C00001
111111111111111111111111111111