111111111111111111111111111111
100000000C0000000000000000N001
1000P000000N000C0000C000000001
10000000C00000000000000C000001
10000C00011111CN0C001011111101
1E0000000000000011111111111111
10000000C00000C000000N00110001
100000N0000C0000C0000000001101
1C00000N0000N0000000C000011101
1N00000000C000000CCC0000N110C1
100000NNNNCC000001111000001001
100000000000011110000011C00001
111111111111111111111111111111