111111111111111
100000000C00001
1000P000000N001
10000000C000001
10000C000111111
1E0000000000001
10000000C000001
111111111111111