111111111111111
100000000C00001
1000P0000000001
10000000C000001
10000C000111111
100000000000001
10000000C000001
111111111111111